000000000000000
000000000000000
000000000000000
000000000000000
000000000000000
000100000000000
111000000000000
010000000000000
000000000000000
000000000000000
000000000000000
001000000000000
111000000000000
000000011100000
000000000000000
000000000000000
1111111100000000
000000011100000
000000010000000
000000010000000