000000000000000
000000000000000
000000000000000
000000111001000
000100000000000
000000000000000
000000000001000
000100000001000
000100000001000
000100000001000
000100000001000
000000100001000
000100000001000
000100000000000
000100000000000
000001010000000
000000011100000
000000000000000
000000000000000
000000000000000