000000000000000
000000000000000
000000000000000
111000111001000
001000000000000
100000000000000
100000000001000
000100000001000
000100000001000
000100000001000
000100000001000
000000100001000
000100000001000
000100000000000
000100000000000
000001010000000
000000011100000
000000000000000
000000000000000
000000000000000