000000000000000
000000000000000
000000010000000
000000000000000
000000000000000
000000000001110
000000000000000
000000000000000
000000000000000
111111100000000
000000100000000
000000000000000
000000000000000
000000000000000
000000000000000
000000000001110
111000000000000
000000010000000
000000000000000
000000000000000