000001000100000
000000000100000
000000000100000
000000000100000
000000000110000
000000000100000
000111111000000
000000000000001
000000000000000
000000000000000
100000000110000
000000000100000
000000000100000
000000000100000
000100000111000
000010000100000
000001000100000
000000000000000
000000000000000
000000000000000